NO ./maps/wall_sprite.xpm
SO ./maps/wall_sprite.xpm
WE ./maps/wall_sprite.xpm
EA ./maps/wall_sprite.xpm

F 220,100,0
C 225,30,0

1111111111
1000011001
100N011001
1000001001
1111111111
