NO ./maps/brickwall.xpm
SO ./maps/brickwall.xpm
WE ./maps/brickwall.xpm
EA ./maps/brickwall.xpm

F 255,255,255
C 50,20,35

111111111111111111111111111111111111111111111
100000000000000000000000000000000000000000001
100000000100000000000000000000000000000000001
100000000000000000000000000000000000000000001
100000000000000100000000000000000000000000001
100000000000000000000000000000000000000000001
10000000E000000000000000000000000000000000001
100000000000000000000000000000000000000000001
100000000000000100000000000000000000000000001
100000000000000000000000000000000000000000001111111111111111111111111111111111111111111111111111111111111111111111111111111111111111111111111111111111111111111111111111111111111111111111111111111111111111111111111111111111111111111111111111111111111111111111111111111111111111111111111111111111111111111111111111111
111111111111111111111111111111111111111111111
