NO ./maps/wall_sprite.xpm
SO ./maps/wall_sprite.xpm
WE ./maps/wall_sprite.xpm
EA ./maps/test.xpm

F 225,193,110
C 173,216,230

111111
101011
100011
100001
1010W1
100001
111111