NO ./maps/wall_sprite.xpm
SO ./maps/wall_sprite.xpm
WE ./maps/wall_sprite.xpm
EA ./maps/wall_sprite.xpm

F 255,255,255
C 255,255,255

11111111111111
100001100000011111111
100001100010011111
100001000000011111
11011111101111
10000010000001
10000000000001
10000W00000001
10000000000001
11111111111111
