NO ./maps/czang.xpm
SO ./maps/brickwall.xpm
WE ./maps/lmaurin.xpm
EA ./maps/brickwall.xpm

F 220,100,0
C 255,30,0

111111111111111111111111
100000000011000000000001
101100000111000000000001
10N100000000000000000001
111111111011000001110001
100000000011000001110111
111101111111110111000001
111101111111110111010101
110000001101010111000001
100000000000000000000001
100000000000000000000001
111111111111111111111111
