WE ./maps/brickwall.xpm
EA ./maps/brickwall.xpm
NO ./maps/brickwall.xpm
SO ./maps/brickwall.xpm

F 225,193,110
C 173,216,230

11111111111111111111111
1N101000000000000000011
10001000000000000000011
10000000000000000000011
10100000000000000000000
10000000000000000000011
10000000000000000000011
11111111111111111111111
11111111111111111111111
