NO ./maps/wall_sprite.xpm
SO ./maps/wall_sprite.xpm
WE ./maps/wall_sprite.xpm
EA ./maps/wall_sprite.xpm

F 0,0,255
C 225,30,50

11111111111111
10000110000001
10000110001001
10000100000001
11011111101111
10000010000001
10000000000001
10000W00000001
10000000000001
11111111111111
