NO ./maps/brickwall.xpm
SO ./maps/brickwall.xpm
WE ./maps/brickwall.xpm
EA ./maps/brickwall.xpm

F 255,255,255
C 50,20,35

11111111111111
10000110000001
10000110001001
10000100000001
11011111101111
10000S10000001
10000000000001
10000000000001
10000010000001
100001 100000011111111111111
10000010000001
10000000000001
10000000000001
10000000000001
10000000000001
10000000000001
10000000000001
11111111111111