NO ./maps/brickwall.xpm
SO ./maps/brickwall.xpm
WE ./maps/brickwall.xpm
EA ./maps/brickwall.xpm

F 220,100,0
C 255,30,0

11111111111111111111111111111
10000000001100000000000011111
10110000011100000000000011111
10N10000000000000000000011111
11111111101100000111000000001
10000000001100000111011111111
11110111111111011100000010001
11110111111111011101010010001
11000000110101011100000010001
10000000000000000000000000001
10000000000000000000000000001
10000000000000000000000000001
10000000000000000000000000001
10000000000000000000000000001
10000000000000000000000000001
10000000000000000000000000001
10000000000000000000000000001
10000000000000000000000000001
10000000000000000000000000001
10000000000000000000000000001
10000000000000000000000000001
10000000000000000000000000001
11111111111111111111111111111
